34	20																		
9	9	9	9	9	9	9	9	9	9	9	9	9	9	9	9	9	9	9	9
9	0	0	0	0	0	0	0	0	0	0	0	0	0	0	0	0	0	0	9
9	0	0	0	0	0	0	0	0	0	0	0	0	0	0	0	0	0	0	9
9	0	0	0	0	0	0	0	0	0	0	0	0	0	0	0	0	0	0	9
9	0	0	0	0	0	0	0	0	0	0	0	0	0	0	0	0	0	0	9
9	0	0	0	0	0	0	0	0	0	0	0	0	0	0	0	0	0	0	9
9	0	0	0	0	0	0	0	0	0	0	0	0	0	0	0	0	0	0	9
9	0	0	0	0	0	0	0	0	0	0	0	0	0	0	0	0	0	0	9
9	0	0	0	0	0	0	0	0	0	0	0	0	0	0	0	0	0	0	9
9	0	0	0	0	0	0	0	0	0	0	0	0	0	0	0	0	0	0	9
9	0	0	0	3	3	3	3	3	3	0	0	3	0	0	3	3	2	2	9
9	0	0	0	0	0	0	0	0	3	0	0	3	0	0	3	0	0	0	9
9	0	0	0	0	0	0	0	0	2	0	0	3	0	0	3	0	0	0	9
9	0	0	0	0	0	0	0	0	2	0	0	3	0	0	3	0	0	0	9
9	0	0	0	0	0	0	0	0	2	0	0	3	0	0	2	0	0	0	9
9	0	0	0	0	0	0	0	0	2	0	0	2	0	0	2	0	0	0	9
9	0	0	0	0	0	0	0	0	2	0	0	2	0	0	2	0	0	0	9
9	0	0	0	0	0	0	0	0	3	0	0	3	0	0	2	0	0	0	9
9	3	3	3	3	3	3	3	3	3	0	0	3	0	0	2	0	0	0	9
9	0	0	0	0	0	0	0	0	0	0	0	3	0	0	3	0	0	0	9
9	0	0	0	0	0	0	0	0	0	0	0	3	0	0	3	0	0	0	9
9	0	0	0	0	0	0	0	0	0	0	0	2	0	0	3	0	0	0	9
9	0	0	0	0	0	0	0	0	0	0	0	2	0	0	0	0	0	0	9
9	0	0	0	0	0	0	0	0	0	0	0	2	0	0	0	0	0	0	9
9	0	0	0	0	0	0	0	0	0	0	0	3	0	0	0	0	0	0	9
9	0	0	0	0	0	0	0	0	0	0	0	3	0	0	0	0	0	0	9
9	0	0	0	0	0	0	0	0	0	0	0	3	0	0	0	0	0	0	9
9	0	0	0	0	0	0	0	0	0	0	0	3	0	0	0	0	0	0	9
9	0	0	0	0	0	0	0	0	0	0	0	0	0	0	0	0	0	0	9
9	0	0	0	0	0	0	0	0	0	0	0	0	0	0	0	0	0	0	9
9	0	0	0	0	0	0	0	0	0	0	0	0	0	0	0	0	0	0	9
9	0	0	0	0	0	0	0	0	0	0	0	0	0	0	0	0	0	0	9
9	0	0	0	0	0	0	0	0	0	0	0	0	0	0	0	0	0	0	9
9	9	9	9	9	9	9	9	9	9	9	9	9	9	9	9	9	9	9	9
